0 0 0 0 0 0 0 0 0 0 0 0 0 0 0 0 0 0 0 0
0 2 2 2 2 2 0 4 3 i 7 6 5 0 3 2 2 2 2 0
0 2 2 2 2 2 0 0 0 0 0 0 0 0 0 0 0 0 2 0
0 2 2 1 2 2 2 2 2 2 2 2 2 2 2 2 2 2 2 0
0 2 2 2 2 2 0 0 0 0 0 0 0 0 2 2 2 2 2 0
0 2 2 2 2 2 0 0 0 0 0 0 0 0 0 0 a 0 0 0
0 0 0 0 0 0 0 0 0 0 2 2 2 2 2 2 2 2 0 0
0 2 2 2 2 2 0 0 0 0 2 2 2 2 2 2 2 2 2 0
0 2 2 2 2 6 2 2 2 0 2 2 2 2 2 2 2 2 2 0
0 3 2 2 2 2 6 2 2 6 2 2 2 2 2 2 2 2 2 0
0 0 a 0 0 0 0 0 0 0 0 0 0 0 0 0 0 0 0 0
0 2 2 2 2 2 2 2 2 3 3 0 2 2 2 2 2 2 2 0
0 2 2 2 2 2 2 2 2 3 3 0 2 3 2 2 2 3 2 0
0 0 d 0 0 0 0 0 0 0 0 0 2 2 2 2 2 2 2 0
0 2 2 2 0 2 2 2 2 4 0 0 2 2 2 4 2 2 2 0
0 2 0 2 0 2 0 2 0 0 0 0 2 4 2 2 2 4 2 0
0 2 0 2 0 2 0 2 2 2 7 5 2 2 4 4 4 2 2 0
0 3 0 2 0 7 0 2 2 2 7 5 2 2 2 2 2 2 2 0
0 4 0 2 2 2 0 2 2 2 7 5 2 2 2 2 2 2 2 0
0 0 0 0 0 0 0 0 0 0 0 0 0 0 0 0 0 0 0 0