0 0 0 0 0 0 0 0 0 0 0 0 0 0 0 0 0 0 0 0
0 7 1 7 0 0 0 2 2 2 2 0 4 2 2 2 2 2 3 0
0 0 2 0 0 0 2 2 2 2 c 2 2 2 2 6 6 6 2 0
0 0 2 0 0 0 2 5 2 2 c 2 2 2 2 6 2 6 2 0
0 0 2 0 0 0 2 2 2 2 c 2 2 2 2 6 2 4 2 0
0 0 2 0 0 0 0 2 2 2 2 0 2 2 2 6 2 2 2 0
0 3 2 2 0 0 0 0 0 0 0 0 2 6 6 2 2 2 7 0
0 0 2 0 0 0 0 0 0 2 2 2 0 2 2 2 2 2 2 0
0 3 4 0 0 0 0 2 4 4 2 2 0 2 2 7 2 2 2 0
0 0 4 0 4 4 4 4 2 2 4 4 2 0 2 2 2 2 2 0
0 2 2 0 2 2 2 2 2 2 2 2 2 0 2 2 2 7 2 0
0 2 6 0 0 2 2 2 2 2 2 2 0 2 2 2 2 2 2 0
0 2 2 0 2 2 2 2 2 0 0 0 6 2 2 2 2 2 2 0
0 6 6 3 2 2 2 2 2 2 2 c 2 2 2 2 2 2 2 0
0 2 2 0 2 2 2 2 2 0 0 0 6 2 2 2 2 0 6 0
0 2 2 0 2 2 2 2 2 2 2 0 3 2 2 2 0 3 2 0
0 0 4 0 2 2 2 2 2 2 2 2 0 0 0 0 2 2 2 0
0 4 4 0 4 2 2 2 4 2 2 2 0 4 2 2 2 2 2 0
0 4 4 0 4 4 4 4 2 4 4 0 0 4 2 2 2 2 2 0
0 0 0 0 0 0 0 0 0 0 0 0 0 0 0 0 0 0 0 0