0 0 0 0 0 0 0 0 0 0 0 0 0 0 0 0 0 0 0 0
0 4 2 3 2 2 7 2 2 2 2 2 2 2 2 2 2 2 2 0
0 0 0 a 0 0 0 0 0 2 0 0 0 2 0 0 0 0 2 0
0 2 2 2 2 2 7 c 2 2 2 2 2 2 0 2 2 2 2 0
0 2 2 3 2 3 2 0 0 2 0 2 0 0 0 2 0 0 2 0
0 2 3 2 3 2 2 0 0 2 0 2 0 3 2 2 0 0 2 0
0 7 2 2 2 2 0 5 i 2 0 2 0 0 0 2 2 2 2 0
0 0 0 0 0 0 0 0 0 2 0 4 a 3 2 2 3 3 2 0
0 3 0 2 2 2 0 2 d 2 0 0 0 0 0 0 0 0 c 0
0 2 2 2 0 2 0 2 0 1 2 2 2 2 4 b 2 2 2 0
0 2 0 2 0 2 0 2 0 d 0 0 0 0 0 2 2 2 2 0
0 2 0 2 0 2 2 2 0 7 7 7 d 2 0 3 3 3 3 0
0 3 0 2 0 2 0 2 0 3 3 3 0 2 3 2 4 4 2 0
0 2 0 2 2 2 0 2 0 0 0 0 0 0 0 3 0 0 0 0
0 4 0 2 0 2 0 2 0 3 2 2 2 2 2 2 2 2 3 0
0 2 0 2 0 2 0 2 0 0 0 0 4 0 3 0 2 0 2 0
0 3 0 2 3 2 0 2 0 2 2 2 2 0 2 0 2 0 4 0
0 7 2 2 0 2 0 2 0 2 0 0 2 0 3 0 2 0 2 0
0 3 0 2 4 2 2 2 c 2 2 2 2 0 4 0 3 2 4 0
0 0 0 0 0 0 0 0 0 0 0 0 0 0 0 0 0 0 0 0