0 0 0 0 0 0 0 0 0 0 0 0 0 0 0 0 0 0 0 0
0 4 7 4 2 4 7 2 7 2 2 2 2 2 2 2 4 4 2 0
0 2 4 2 4 2 2 2 2 2 2 2 2 2 2 2 2 4 4 0
0 4 7 2 2 2 2 2 2 2 2 2 2 2 7 7 7 7 2 0
0 2 4 2 7 2 2 2 2 2 2 2 2 4 7 2 2 7 2 0
0 4 7 2 7 2 2 2 2 2 2 2 7 7 7 2 2 7 2 0
0 2 7 2 7 2 2 2 2 2 2 7 7 2 2 2 2 7 2 0
0 4 4 7 2 2 2 2 2 2 7 7 2 2 2 2 2 7 2 0
0 2 2 2 2 2 2 2 2 2 7 2 2 2 2 2 2 2 2 0
0 4 2 7 2 2 2 2 2 1 2 2 2 2 2 2 2 2 4 0
0 2 2 2 2 2 2 2 2 2 2 2 2 2 2 2 2 2 2 0
0 4 2 7 7 2 2 2 2 2 2 2 2 2 4 2 4 2 2 0
0 2 4 2 2 2 2 2 2 2 2 2 2 2 2 2 2 7 2 0
0 2 2 2 7 2 2 2 2 2 2 2 2 2 2 2 2 7 2 0
0 4 2 4 2 2 2 2 2 2 2 2 2 2 2 2 4 7 2 0
0 4 4 2 2 2 2 2 2 2 2 7 2 4 2 4 2 7 2 0
0 4 4 2 4 2 2 2 2 2 4 2 7 2 2 2 2 7 4 0
0 4 4 4 4 2 4 2 2 2 2 2 4 7 4 2 4 7 2 0
0 2 4 2 2 2 2 2 2 4 2 2 2 2 2 7 7 7 2 0
0 0 0 0 0 0 0 0 0 0 0 0 0 0 0 0 0 0 0 0