0 0 0 0 0 0 0 0 0 0 0 0 0 0 0 0 0 0 0 0
0 2 1 2 2 6 2 6 2 7 2 2 7 0 0 2 2 2 2 0
0 2 2 2 6 2 6 2 4 2 2 2 2 0 0 2 5 5 2 0
0 6 6 6 2 6 3 6 2 2 2 4 2 2 0 2 5 5 2 0
0 2 6 6 6 2 6 2 a a 2 2 2 2 0 2 2 2 2 0
0 2 3 6 2 6 6 a 3 3 a 2 2 2 0 0 a d 0 0
0 6 2 6 6 2 2 2 a a 2 2 2 2 2 0 a b 0 0
0 3 6 2 2 6 2 2 2 2 2 2 4 2 2 0 d a 0 0
0 6 2 2 2 2 6 2 2 2 2 2 2 2 2 0 2 2 0 0
0 3 6 2 6 2 6 2 2 2 2 2 7 2 0 2 2 2 2 0
0 6 2 6 2 2 6 2 2 2 2 2 0 0 2 2 2 2 2 0
0 6 6 6 6 6 2 2 2 2 2 0 0 2 2 2 2 2 2 0
0 2 6 6 6 6 6 2 2 2 2 0 2 2 3 2 2 2 2 0
0 2 2 2 6 6 6 2 2 0 0 0 2 2 2 2 2 2 2 0
0 2 4 2 4 6 6 2 0 0 0 2 2 2 6 2 2 2 2 0
0 2 2 4 2 2 6 2 0 0 0 2 2 3 2 2 2 2 2 0
0 2 2 2 2 2 6 6 2 0 6 2 6 2 2 2 2 4 2 0
0 2 2 2 2 2 3 6 2 b 2 2 2 2 6 2 2 2 2 0
0 2 2 2 2 2 6 2 2 0 0 2 2 2 2 2 4 2 2 0
0 0 0 0 0 0 0 0 0 0 0 0 0 0 0 0 0 0 0 0