0 0 0 0 0 0 0 0 0 0 0 0 0 0 0 0 0 0 0 0
0 1 3 b 2 2 2 2 2 6 3 3 3 2 2 b 2 2 2 0
0 b 2 2 d 2 2 2 6 2 6 3 3 3 2 b 2 0 2 0
0 7 b 2 2 c 2 2 2 6 2 6 3 3 3 b 2 0 2 0
0 2 2 d 2 2 i 2 2 2 6 2 6 3 2 b 2 0 2 0
0 2 2 2 e 2 2 c 2 2 2 6 2 6 2 b 2 0 2 0
0 c 2 2 2 f 2 2 b 2 2 2 6 2 2 b 2 0 2 0
0 7 h 2 2 2 a 2 2 b 2 2 2 6 2 b 2 0 2 0
0 7 7 i 2 7 3 g 2 2 z z z z z b 2 0 2 0
0 c 7 7 d 3 d 2 2 2 2 2 2 2 2 2 2 0 2 0
0 2 c c 2 f 2 2 2 0 0 0 0 0 0 0 0 0 2 0
0 3 2 2 2 2 2 2 2 0 2 2 2 2 2 2 2 2 2 0
0 3 2 2 2 2 2 2 2 0 2 0 0 0 0 0 0 0 0 0
0 2 d d 2 d d 2 h 0 2 0 2 2 2 2 2 2 2 0
0 d 3 3 d 7 3 d 7 0 2 0 2 0 0 0 0 0 2 0
0 2 d d 2 d d 2 h 0 2 0 2 0 4 4 4 4 4 0
0 3 2 2 2 2 2 2 2 0 2 0 2 0 4 4 4 4 4 0
0 a 2 a 2 a 2 a 2 0 2 0 2 0 4 4 4 4 4 0
0 7 0 7 0 7 0 7 0 0 2 2 2 0 4 4 4 4 5 0
0 0 0 0 0 0 0 0 0 0 0 0 0 0 0 0 0 0 0 0