0 0 0 0 0 0 0 0 0 0 0 0 0 0 0 0 0 0 0 0
0 1 2 2 2 2 6 6 6 2 2 2 2 0 0 0 0 0 0 0
0 2 2 6 2 2 2 6 2 6 2 4 2 4 2 0 0 0 0 0
0 2 2 2 2 2 6 2 6 2 4 2 2 2 2 2 2 0 0 0
0 6 6 2 2 6 6 2 6 6 2 2 4 2 2 4 2 0 0 0
0 2 2 6 2 6 2 2 2 6 4 2 2 2 2 2 2 4 0 0
0 2 6 2 6 2 2 6 2 2 2 2 4 2 4 2 2 2 0 0
0 6 2 6 2 6 2 2 6 2 4 4 2 2 2 2 4 2 2 0
0 2 2 2 2 6 2 6 2 2 2 2 2 4 4 2 2 2 4 0
0 2 4 2 6 2 6 6 2 2 6 2 2 4 2 2 2 2 2 0
0 2 4 2 2 4 2 2 6 6 2 2 6 2 2 4 2 4 2 0
0 2 2 4 2 4 6 4 2 2 2 2 2 6 6 2 2 2 2 0
0 2 4 2 2 2 4 6 4 6 2 2 2 2 2 6 4 2 2 0
0 0 2 2 4 2 2 4 2 2 6 2 2 2 2 2 6 4 2 0
0 0 2 2 2 2 2 4 2 2 4 6 2 2 2 2 2 6 6 0
0 0 0 2 2 4 2 2 2 2 2 2 6 2 2 2 2 2 4 0
0 0 0 2 2 2 2 2 2 2 2 2 6 4 2 2 2 2 2 0
0 0 0 0 0 2 2 2 2 2 2 2 2 6 6 2 2 2 2 0
0 0 0 0 0 0 0 2 2 2 2 2 2 2 2 6 2 2 5 0
0 0 0 0 0 0 0 0 0 0 0 0 0 0 0 0 0 0 0 0