0 0 0 0 0 0 0 0 0 0 0 0 0 0 0 0 0 0 0 0
0 2 2 2 2 2 2 2 2 2 2 2 2 2 2 2 2 2 2 0
0 2 4 4 4 4 4 2 h 2 2 h 2 7 7 7 7 7 2 0
0 2 2 2 4 2 2 2 h 2 2 h 2 7 2 2 2 2 2 0
0 2 2 2 4 2 2 2 h h h h 2 7 7 7 2 2 2 0
0 2 2 2 4 2 2 2 h 2 2 h 2 7 2 2 2 2 2 0
0 2 2 2 4 2 2 2 h 2 2 h 2 7 7 7 7 7 2 0
0 2 2 2 2 2 2 2 2 2 2 2 2 2 2 2 2 2 2 0
0 2 2 2 2 2 2 2 2 2 2 2 2 2 2 2 2 2 2 0
0 2 2 2 2 2 2 2 2 2 2 2 2 2 2 2 2 2 2 0
0 2 2 2 2 2 2 2 2 2 2 2 2 2 2 2 2 2 2 0
0 2 6 0 6 0 6 2 3 2 2 2 3 2 d d d 2 2 0
0 2 0 2 2 2 2 2 3 3 2 2 3 2 d 2 2 d 2 0
0 2 6 2 2 2 2 2 3 2 3 2 3 2 d 3 2 d 2 0
0 2 0 6 0 2 2 2 3 2 3 2 3 2 d 1 3 d 2 0
0 2 6 2 2 2 2 2 3 2 3 2 3 2 d 3 2 d 2 0
0 2 0 2 2 2 2 2 3 2 2 3 3 2 d 2 2 d 2 0
0 2 6 0 6 0 6 2 3 2 2 2 3 2 d d d 2 2 0
0 2 2 2 2 2 2 2 2 2 2 2 2 2 2 2 2 2 2 0
0 0 0 0 0 0 0 0 0 0 0 0 0 0 0 0 0 0 0 0